NO ./textures/North1.png
EA ./textures/East1.png
WE ./textures/West1.png
SO ./textures/South1.png

F 115,95,20
C 117,14,33



 1111111111111111111
110000000000000001
100111111111110011
10010000000001000111111111111
10W000001110001000000011110001
100000000100010000000000000011
10010011010001111100000000001
100000010100000001000100000011
11110001011111110100010000001
10000000000000000000011111111
11111111111111111111111111111
10011111111111110100000000001
10010000000000000001111111001
10010000000000000000000000011
1001000000000000000000000001
 1111111111111111111111111111

