NO ./textures/North1.png


C 117,143,55


EA ./textures/East1.png
SO ./textures/South1.png 

             

F 115,95,20
WE                         ./textures/West1.png


11
 
1111111111111111111
1000000000000000001
1000000001000000001
10S0000000000000001
1111111111111111111
111
11
