NO ./textures/North1.png
EA ./textures/East1.png
WE ./textures/West1.png
SO ./textures/South1.png

F 115,95,20
C 117,14,33




111111111111111111111
100000000000000000001
100000000000000000001
100000000N00000000001
100000000000000000001
111111111111111111111

